0211011221212122222021221
0120012102100102222212021
1202201210012102222020120
0021012212210110012011122
1211121020100122212201010
0202012211111201010020020
0122010110202002000100120
0110102101020111020021021
1201002110102022000121010
0022200120200112122121011
0101201211101002102022212
2112201010102012112010212
1211100012101211012012012
1221121120002011221221011
2021221000020012111012202
0002102000220002211200022
2122220121020202220222012
0221112211222200021120010
2100100102221200110211201
0020002222111022111010101
1001210022020112022100022
2002212210002102100020020
0122222000210211122001102
1001100002102212002200112
0101021211011111100001110
