1220121200211221122001201
0102010100221012002221200
1222021211002120010222222
1120222100211022220002012
0121022122111202210101002
1111202121201100012021211
2210002200102120000110222
2102220110011012200120100
1121200210201201212012220
0220012112110111210200011
0210000101021021000201001
2200010000021011010212110
2020222012210122220021212
1212212111011021112022020
0220220000002220001002200
2022111211212022101102112
1012221202201101011100000
0002121000101101221001201
1020002111012112010210121
0211000001210020222020202
2111212112020211221200101
0221212112221200212122200
2220111102211202220202001
0122011201210022020122022
1002200221120201200012200
