1121200121201112221000112
1001011000020201102020111
0101001021112112101112101
2011222112022111000221101
0222212011111021022211211
1020202012001121010020020
2000011210101110120122001
2011001010211122100020200
2022201021021212111122120
1001202101202012100202121
0222111012220010220010100
2220221212202110100121222
0221212222020001222011011
0021120001022001122212210
1011020111220010222022220
2200220110020220222110222
0221222101001221100111202
0101222212110201102111012
2010111011200201212120211
0021201121120211122212221
2012102002100101102220022
1102102110202002120121112
2201202121211202020212210
0102110201212002020121121
2011010022212202121210122
