1152111111111111111111001
1150000000000000000000011
1150000000000000000000011
1122000000000000002111111
1100000000000000000000011
1111001112222222111222011
1500000010000000111000011
1511111111331111111111111
1500000000110000000000001
1500000000000000000110111
1500000000000000000013111
1110000000000000000001001
1112200000000000000000221
1000000000000000000000001
1000000000000000444000000
1000000000440000000000000
1130000000000300000000111
1110000000000100000000001
1010000000000003000220001
0211000040000001000000000
1111000000000000000000001
0000000000000000000000000
1000000000000000000000000
1114433333333333333344111
1111111111111111111111111