1150011111111111111112221
1152201111000000000000000
1150000111115111111111100
1100000010105000001111111
1110000000000000000001111
1110000000000000000000001
1112000002222222220000001
1110000000000000000000001
1110022000000000000022001
1100000000000000000000001
1501111111111111111111111
1511111111111111110000000
1500000111111111100000000
1500000111111111100000011
1500000000000000000000311
1111111100000000003000111
1110000000000000011343111
1110000022211000111111111
1111110000011100111100011
1111110000000000000000001
1111111110001112222200001
0050000000000110000000000
1052220000000111050000000
1050111111111100251110220
1050111111111111151110011
