1222111111111111151111111
1000111111100000050000000
1500000000000222222222000
1511111111113333333333311
1500000000111111111111111
1500000000000000000011111
1500000001100000000000001
1100110001115111111122221
1000000001005110000001111
1000000001215110001101111
1000000001115110111100000
1333333000005000111120000
1111111111111110111001220
0000000000000000110011110
1000000111111111111110000
1221111111111111111111100
1000000111111111110000001
1100010000000000000122221
1111111115000005111111111
0000000015111115100000000
0000000005000005000000011
0000000005000005000000000
0000000111111111110000000
1113000000000000050003111
1111111111111111151111111