1222111111111111151111111
1000111111100000050000000
1000000000000222222222000
1611111111113333333333311
1500000000111111111111111
1500000000000000000011111
1500000001100000000000001
1100110001116111111122221
1000000001005110000001111
1000000001215110001101111
1000000001115110111100000
1333333000005000111120000
1111111111111110111001220
0000000000000000110011110
1000000111111111111110000
1221111111111111111111100
1000000111111111110000001
1100010000000000000122221
1111111110000000111111111
0000000016111116100000000
0000000005000005000000111
0000000005000005000000001
0000000111111111110000001
1613000000000000000003111
1511111111111111111111111